###########################
#············#············#
#·####·#####·#·#####·####·#
#·####·#####·#·#####·####·#
#·························#
#·####·#·#########·#·####·#
#······#·····#·····#······#
##¤###·#####·#·#####·###$##
#······#·····#·····#······#
#·####·#·#########·#·####·#
#·························#
#·####·#####·#·#####·####·#
#·####·#####·#·#####·####·#
#············#············#
###########################