########
# ·····#
# ####·#
#$····¤#
########